     .   .     .         .       .   .  |
----+ +-+ +---+ +---+     +-----+ +-+ +-|
    + | | +   \     |     |      .|  .  |
 -\  .+ +.  +  X----+-+-+ | +---+ + +-+ |
   \+  .  /-++ |      | | | |    .  |   |
++ +-----/   + | +----+ | | | +-----+ +-|
.| |       +   | +--+   | | |.       .  |
.| | +-----+---+    | +-+ | | +-+---+ +-|
.| |.          +--+ | |   | |.  |   | + |
.| | +---+-+-+    | | | +-+ | + | + |   |
.| | +   +   +--+ + + | +-+ | | + | +---|
.| |   +  .+ .  |  .  |   | | |   |     |
.| +---+-+ ++ + +-+ + +-+ + +-+---+-+-+ |
.| |     .. | |     |   |. .          | |
.| + +--+ + | +-----+-+ | + +---+---+-+ |
.|. .|    | | |        .| | |   |   |  .|
.| + +----+ | | +-----+ | | | + + + + + |
.| |      | | |       | | | | |   |   | |
.| +----+ | + +-----+ | +-+ | +---+---+-|
.|        |  .        |     |           |
map2