     .   .     .         .      !.   .  |
----+ +-+ +---+ +---+     +-----+ +-+ +-|
    + | | +   \     |     |      .|  .  |
 -\  .+ +.  +  X----+-+-+ | +---+ + +-+ |
   \+  .  /-++ |      | | | |    .  |   |
++ +-----/   + | +----+ | | | +-----+ +-|
.| |       +   | +--+   | | |.       .  |
.| | +-----+---+    | +-+ | | +-+---+ +-|
.| |.          +--+ | |   | |.  |   | + |
.| | +---+-+-+    | | | +-+ | + | + |   |
.| | +   +   +--+ + + | +-+ | | + | +---|
.| |   +  .+ .  |  .  |   | | |   |     |
.| +---+-+ ++ + +-+ + +-+ + +-+---+-+-+ |
.| |     .. | |     |   |. .          | |
.| + +--+ + | +-----+-+ | + +---+---+ ++|
.|. .|    | | |        .| | |   |   |   |
.| + +----+ | | +-----+ | | | + + + +-+ |
.| |      | | |       | | | | |   |     |
.| +----+ | + +-----+ | +-+ | +---+---+-|
.|        |  .        |     |           |
map1